=######===
##  X ####
#        #
#  XCO   #
#        #
# T  P   #
#    B   #
#        #
# TC    E#
##########
