=######===
##  X ####
#        #
#  XCO   #
#        #
# T  P   #
#    B   #
#        #
# TC  C E#
##########
